222222222222222222222222222222
213333333333333333333333332222
240000000000000000000000008222
240000000000000000000000000522
240000000000000000000000000522
240000000000000000000000000522
240000000000000000000000000522
240000000000000000000000000522
226000000071116000000000000522
224000000083224000000000000052
222600000000522600000000000052
222211600007222260000000000722
222222400072222226000000071222
222222211122222222160760722222
222222222222222222222222222222